NO ./assets/texture/wall_42b.png
SO ./assets/texture/wall_l.png
EA ./assets/texture/wall_42b.png
WE ./assets/texture/wall_d.png

F 10,20,20
C 10,20,30

        1111111111111111111111111
        1000000000110000000000001
        1011000001110000000000001
        1001000000000000000000001
111111111011000001110000000000001
100000000011000000010111111111111
11110111111111011100000010001
11110111111111011101010010001
11000000110101011100000010001
10000000000000001100000010001
10000000000000000001010000001
11000001110101011101011010N0111
11110111 1110101 101111010001
11111111 1111111 111111111111
