EA ./assets/textures/ast.png
WE ./assets/textures/wall3.png
SO ./assets/textures/ast.png
NO ./assets/textures/wall3.png

F 10,20,20
C 10,20,30

111111
100101
100001
1100N1
111111